111111111
100000001
1000P0001
100000001
111111111