11111111111111111
10000001000E00001
10C00001000000001
100000000C0000001
10000000000000001
10P00000000000001
11111111111111111