1111111111111
1000000100001
1000P00100001
1000000000001
1111111111111