1111111111111
10000001000E1
10C0P00100001
100000000C001
1111111011111
1000000000001
1000000000001
1000000000001
1000000000001
1111111111111