11111111111111111
10000001000000001
10C00001000000001
1000P0000C000E001
10000000000000001
10000000000000001
11111111111111111
