11111111111111111
10000000000000001
10C00000000000001
100000000C000E001
10000000000000001
1000P000000000001
11111111111111111