1111111111111
1000000100001
10C0P00100001
100000010C001
1111101111111
1000000000001
1000000000001
100000E000001
1000000000001
1111111111111