1111111111111
1P00E000000C1
1000000000001
100000E0P0001
1000000000001
1111111111111